4 12 75 190 0 1 4 1
0 1 0 0 0 0 0 0 0 0 -1 0 
0 1 0 0 0 0 0 0 0 0 3 0 
0 1 0 0 2 2 2 1 0 0 3 0 
0 2 2 2 3 0 0 2 2 2 3 0 
