5 12 75 115 1 1 5 3
0 0 0 0 0 0 0 2 1 0 0 0 
0 1 0 0 0 0 0 3 2 2 -1 0 
0 1 0 0 0 2 2 3 0 0 0 0 
0 1 0 0 0 3 0 0 0 0 0 0 
0 2 2 2 2 3 0 0 0 0 0 0 
